NO img/north.xpm
WE img/west.xpm
SO img/south.xpm

EA img/east.xpm



F 0  , 32  , 0  
C 120 ,  0 ,   16    

                1111111111111111111111111
                1000000000110000000000001 
                1011000001110000000000001 
                100100000000000100N010001 
11111111101100000111000000000000111111111 
100000000011000001110111110111111 
11110111111111011100000010001
11110111111111011101010010001
11000000110101011100000000001
11111111111111111111111111111
