NO            img/north.xpm
WE img/west.xpm
SO img/south.xpm




EA img/east.xpm

F 0,32,0
C 120,0,16

        1111111111111111111111111     11111111
        1000000000110000000000001     10000001
        1011000001110000000000001     1000N001
        1001000000000000000000001     10000001
111111111011000001110000000000001      1000001
100000000011000001110111110111111      1111111
11110111111111011100000010001
11110111111111011101010010001
11000000110101011100000000001
11101111111111111111111111111
  101
11101111111111111111111111111
10000000000000001100000010001
10000000000000001101010010001
1100000111010101111101111000111
11110111 1110101 101111010001
11111111 1111111 111111111111
