NO img/MARBFAC2.xpm
WE img/SKULWALL.xpm
SO img/MARBFACE.xpm
EA img/SKULWAL3.xpm

F 0,32,0
C 120,0,16

1111
1001
1N01
1001
1111