NO img/ravenclaw.xpm
WE img/hufflepuff.xpm
SO img/gryffindor.xpm

EA img/slytherin.xpm



F 0, 32    , 0
C 120,  0,   16

                1111111111111111111111111
                1000000000110000000000001 
                1011000001110000000000001 
                1001000000000000000000001 
11111111111100000111000000000000111111111 
100000000011000001110111110111111 
11110111111111111100000010001
11110111111111011101010010001
1000000W110101011100000000001
01111111111111111111111111111
